5;0;0;0;0;0;2;10
5;2;0;0;0;0;1,9;50
7;3;1;0;0;0;1,8;50
5;3;3;0;0;0;1,7;50
6;2;3;1;0;0;1,6;50
4;4;4;3;0;0;1,5;50
5;3;4;4;2;0;1,5;50
3;5;5;5;2;0;1,5;50
4;5;5;5;3;0;1,5;50
5;3;6;6;4;0;1,5;50
5;5;6;5;5;0;1,4;50
4;7;6;7;4;0;1,4;50
4;8;8;6;4;0;1,4;50
5;9;9;5;4;0;1,4;50
6;8;10;5;5;0;1,4;50
7;9;8;9;3;0;1,3;50
9;7;7;10;5;0;1,3;50
8;8;8;8;8;0;1,3;50
9;7;9;10;8;0;1,3;50
9;9;9;9;8;0;1,3;50
