5;0;0;0;0;0;1,3,5
7;3;0;0;0;0;1,3,8
6;4;2;0;0;0;1,3,8
5;5;5;0;0;0;1,3,8
5;5;4;4;0;0;1,3,8
4;4;6;6;0;0;1,3,8
3;3;7;7;2;0;1,3,8
5;5;6;6;3;0;1,3,8
5;5;7;7;4;0;1,3,8
6;3;8;8;5;0;1,3,8
5;0;0;0;0;0;1,3,8
5;0;0;0;0;0;1,3,8
5;0;0;0;0;0;1,3,8
5;0;0;0;0;0;1,3,8
