5;0;0;0;0;0;2
5;2;0;0;0;0;1,9
7;3;1;0;0;0;1,8
5;3;3;0;0;0;1,7
6;2;3;1;0;0;1,6
4;4;4;3;0;0;1,5
5;3;4;4;2;0;1,5
3;5;5;5;2;0;1,5
4;5;5;5;3;0;1,5
5;3;6;6;4;0;1,5
5;5;6;5;5;0;1,4
0;0;0;0;0;0;1,4
0;0;0;0;0;0;1,4
0;0;0;0;0;0;1,4
0;0;0;0;0;0;1,4
0;0;0;0;0;0;1,3
0;0;0;0;0;0;1,3
0;0;0;0;0;0;1,3
0;0;0;0;0;0;1,3
0;0;0;0;0;0;1,3
